Apple|Apple
Walmart|Walmart
Exxon Mobil|exxonmobil
J.P. Morgan|jpmorgan
McKesson|deray
Berkshire Hathaway|WarrenBuffett
UnitedHealth Group|UnitedHealthGrp
CVS Health|CVSHealth
General Motors|GM
AT&T|ATT
Ford Motor|Ford
General Electric|generalelectric
AmerisourceBergen|Healthcare_ABC
Chevron|Chevron
Verizon|verizon
Costco|Costco
Fannie Mae|FannieMae
Kroger|kroger
Walgreens Boots Alliance|AllianceBoots
HP|HP
Amazon.com|amazondeals
Cardinal Health|cardinalhealth
Boeing|Boeing
Bank of America Corp.|BofA_Corp
Microsoft|Microsoft
Wells Fargo|WellsFargo
Home Depot|HomeDepot
Citigroup|C_PR
Phillips 66|Phillips66Co
Valero Energy|ValeroEnergy_
IBM|IBM
Anthem|anthem_official
Procter & Gamble|ProcterGamble
Alphabet|LeanderAlphabet
Target|Target
Comcast|comcast
Johnson & Johnson|JNJNews
MetLife|MetLife
Archer Daniels Midland|TradeADMIS
Marathon Petroleum|MarathonPetroCo
Freddie Mac|FreddieMac
Aetna|Aetna
United Technologies|UTC
PepsiCo|PepsiCo
Lowe’s|Lowes
UPS|UPS
AIG|AIGinsurance
Prudential Financial|PrudentialNews
Intel|intel
Humana|Humana
Disney|Disney
Cisco Systems|cisco
Pfizer|pfizer
Dow Chemical|DowChemical
FedEx|FedEx
Sysco|Sysco
Caterpillar|CaterpillarInc
Lockheed Martin|LockheedMartin
HCA Holdings|DMEHCAHoldings
Coca-Cola|CocaCola
New York Life Insurance|danchamberlain
Ingram Micro|IngramMicroInc
American Airlines Group|PSAAirlinesInc
Tyson Foods|TysonFoods
Nationwide|Nationwide
Johnson Controls|johnsoncontrols
Delta Air Lines|Delta
Best Buy|BestBuy
Merck|Merck
Goldman Sachs Group|WealthEnvision
Honeywell International|MiquelAC
Oracle|Oracle
Morgan Stanley|MorganStanley
Cigna|Cigna
Allstate|Allstate
TIAA|TIAA
INTL FCStone|INTLFCStone
CHS|gembrit
Publix Super Markets|PattiBreckenrdg
Gilead Sciences|GileadSciences
American Express|AmericanExpress
General Dynamics|GDMS
Nike|Nike
TJX|tjx
ConocoPhillips|conocophillips
World Fuel Services|wfscorp
Mondelez International|MDLZ
3M|3M
Exelon|Exelon
Twenty-First Century Fox|TFCFGGG
Time Warner|twxcorp
Deere|JohnDeere
Tesoro|El_Tesoro
Northwestern Mutual|NM_News
DuPont|DuPont_News
Avnet|Avnet
Macy’s|Macys
Philip Morris International|IndraZemzoum
Rite Aid|riteaid
McDonald’s|McDonalds
Tech Data|Tech_Data
Capital One Financial|RelianceCapital
Sears Holdings|SearsHoldings
EMC|DellEMC
Qualcomm|Qualcomm
USAA|USAA
Duke Energy|DukeEnergy
Time Warner Cable|TWC
Halliburton|Halliburton
Arrow Electronics|ArrowGlobal
Northrop Grumman|northropgrumman
Raytheon|Raytheon
AbbVie|abbvie
Community Health Systems|FedAmerHospital
Alcoa|Alcoa
Centene|Centene
Emerson Electric|JoAnnEmerson
International Paper|IntlPaperCo
Union Pacific|UnionPacific
Amgen|Amgen
U.S. Bancorp|USB
Staples|Staples
Whirlpool|WhirlpoolCare
Danaher|Declan_Danaher
Aflac|Aflac
Abbott Laboratories|Abbott_Labs
AutoNation|AutoNation
Progressive|Progressive
Tenet Healthcare|tenethealth
Dollar General|DollarGeneral
Eli Lilly|LillyPad
Southwest Airlines|SouthwestAir
Penske Automotive Group|penskeautomall
ManpowerGroup|ManpowerGroup
Starbucks|Starbucks
Paccar|paccar
Kohl’s|Kohls
Cummins|Cummins
Altria Group|Altria__Group
Xerox|Xerox
Kimberly-Clark|KCCorp
Kraft Heinz|KraftHeinzCo
AECOM|AECOM
Lear|LearCapital
Fluor|FluorCorp
Jabil Circuit|jabil2circuit2
Facebook|facebook
Supervalu|SuperValuIRL
CenturyLink|CenturyLink
Southern|SouthernRailUK
General Mills|GeneralMills
NextEra Energy|NextEraEnergyR
Thermo Fisher Scientific|thermofisher
American Electric Power|AEPnews
Bristol-Myers Squibb|bmsnews
PNC Financial Services Group|PNCNews
Goodyear Tire & Rubber|goodyear
Nucor|NucorCorp
Micron Technology|MicronTech
Freeport-McMoRan|FM_FCX
Health Net|healthnet
Colgate-Palmolive|CP_News
ConAgra Foods|jonjayharris
Gap|Gap
Baker Hughes|BHInc
PPG Industries|ppgindustries
Whole Foods Market|WholeFoods
Dollar Tree|DollarTree
Genuine Parts|PendudukNgapak
Icahn Enterprises|Carl_C_Icahn
Performance Food Group|blanchandshock
Omnicom Group|Omnicom
DISH Network|CBSSportsNet
FirstEnergy|FEStadium
Monsanto|MonsantoCo
AES|AESEletropaulo
National Oilwell Varco|NOVGlobal
NRG Energy|nrgenergy
CarMax|CarMax
Western Digital|WesternDigital
Marriott International|marcgraser
Office Depot|officedepot
Nordstrom|Nordstrom
DaVita HealthCare Partners|Rosiestep
Aramark|Aramark
Kinder Morgan|Kinder_Morgan
Molina Healthcare|molinahealth
WellCare Health Plans|Steckel7
Visa|Visa
CBS|CBS
Lincoln National|NationalMallNPS
Ecolab|Ecolab
Kellogg|KelloggCompany
Textron|Textron
Illinois Tool Works|ITWInc
Loews|Loews_Hotels
Synnex|SYNNEX
Viacom|Viacom
HollyFrontier|Holly_Frontier
PBF Energy|nationalgridPBF
Devon Energy|DevonEnergy
Land O’Lakes|LandOLakesKtchn
Yum Brands|yumbrands
Texas Instruments|TXInstruments
Waste Management|WasteManagement
Marsh & McLennan|MMC_Global
CDW|CDWCorp
Chesapeake Energy|Chesapeake
Occidental Petroleum|OXY_Petroleum
Parker-Hannifin|ParkerHannifin
Consolidated Edison|Con_Edi_USA_
Cognizant Technology Solutions|Cognizant
J.C. Penney|J_C_Penney
VF|VFBeauty
Ameriprise Financial|ameriprise
Computer Sciences|WisconsinCS
L Brands|L_Brands
Jacobs Engineering Group|RktSciRecruiter
Principal Financial|principal
Bed Bath & Beyond|BedBathBeyond
Ross Stores|Ross_Careers_ny
Toys “R” Us|ToysRUs
Leucadia National|Berkadia
Las Vegas Sands|LasVegasSands
CSX|CSX
United States Steel|dennisogbe
Edison International|edisonintl
L-3 Communications|NinaRVegas
Dominion Resources|DomNews
First Data|FirstData
ADP|ADP
BlackRock|blackrock
Entergy|Entergy
Voya Financial|VoyaFA
Sherwin-Williams|SherwinWilliams
WestRock|WestRock
R.R. Donnelley & Sons|EDGAR_Online
Stanley Black & Decker|RamanaGogula
Murphy USA|MurphyUSA
CBRE Group|CBREHongKong
Xcel Energy|XcelEnergyMN
D.R. Horton|DRHorton
Estee Lauder|EsteeLauder
State Street Corp.|StateStreetCorp
Biogen|biogen
Praxair|PraxairInc
Unum Group|unumrecruit
Group 1 Automotive|Group1Auto
Reynolds American|RAI_News
Henry Schein|HenrySchein
Public Service Enterprise Group|PSEGNews
BB&T Corp.|askBTT
Norfolk Southern|nscorp
DTE Energy|DTE_Energy
Global Partners|GlobalPartnersD
Assurant|AssurantMatters
Huntsman|JonHuntsman
Becton Dickinson|BDandCo
Sempra Energy|SempraEnergy
Navistar International|alltrucksalesco
Discover Financial Services|discover
AutoZone|autozone
Liberty Interactive|LibertyInteract
Stryker|Stryker_Jobs
W.W. Grainger|salvadorsteven
Baxter International|baxter_intl
Air Products & Chemicals|airproducts
Western Refining|westernrefining
Universal Health Services|UHSClosedDoors
Owens & Minor|Owens_Minor
Charter Communications|CharterNewsroom
Advance Auto Parts|AdvanceAuto
MasterCard|Mastercard
Applied Materials|Applied_Blog
Eastman Chemical|EastmanChemCo
Sonic Automotive|SonicAutomotive
CST Brands|CornerStoreKim
Ally Financial|allyfinancial
eBay|eBay
Lennar|Lennar
GameStop|GameStop
Hormel Foods|HormelFoods
Genworth Financial|GNWFinancial
Celgene|Celgene
Priceline Group|PricelineGroup
Fidelity National Financial|FidelityNF
Autoliv|Autoliv_Safety
MGM Resorts International|MGMNatlHarbor
Republic Services|RepublicService
Univar|Univar
Corning|Corning
Mosaic|MosaicLA
Core-Mark Holding|CoreMarkHolding
EOG Resources|eog4f8f0206406
Cameron International|Cameron_Intl
Crown Holdings|CrownFibre
Veritiv|Veritiv
Laboratory Corp. of America|LABCORP
Pacific Life|pacificlife
News Corp.|newscorp
SunTrust Banks|anndharrell
Avis Budget Group|GoAvisBudget
Jarden|jarden
American Family Insurance Group|amfam
Broadcom|Broadcom
Level 3 Communications|Level3
United Natural Foods|UNFI
Dean Foods|deanfoods
Tenneco|TennecoJobs
Mohawk Industries|mhkgreenworks
Campbell Soup|CampbellSoupCo
PVH|pvh
BorgWarner|BorgWarner
O’Reilly Automotive|TimothyCOReilly
Ball|PlayBall
Eversource Energy|EversourceCorp
Lithia Motors|lithiamotors
Franklin Resources|fti_us
Masco|MascoCorp
Newmont Mining|Newmont
KKR|kkrofficial
Oneok|ONEOK
SpartanNash|turntospartan
PPL|PPLUK
Quanta Services|Quanta_Services
XPO Logistics|XPOLogistics_Eu
Interpublic Group|InterpublicIPG
Steel Dynamics|WorldSteelDyn
Ralph Lauren|RalphLauren
WESCO International|WescoDesign
Quest Diagnostics|QuestDX
Boston Scientific|bostonsci
Foot Locker|footlocker
AGCO|AGCOcorp
Hershey|Hersheys
CenterPoint Energy|CNPalerts
Dick’s Sporting Goods|DICKS
Williams|WilliamsUpdates
Live Nation Entertainment|LiveNationASIA
Mutual of Omaha Insurance|Will_Martin16
W.R. Berkley|WRBerkleyCorp
Avon Products|lsoupeau
Darden Restaurants|darden
LKQ|LKQCorp
Kindred Healthcare|kindredhealth
Sealed Air|Sealed_Air
Weyerhaeuser|Weyerhaeuser
Huntington Ingalls Industries|HIIndustries
Dover|DoverAthletic
Netflix|netflix
EMCOR Group|EmcorInfo
Dillard’s|Dillards
Jones Financial|Fanfaronade
salesforce.com|SalesCloud1
Expedia|Expedia
UGI|UGI_Utilities
Apache|TheASF
Asbury Automotive Group|AsburyAutoGroup
Ryder System|RyderSystemInc
Hess|HessCorporation
Terex|My_Terex
Coca-Cola European Partners|CocaColaEP_es
Cablevision Systems|cvc206
Auto-Owners Insurance|DhadleyYaBoy
CMS Energy|cms_energy
Calpine|Calpine
Symantec|symantec
Charles Schwab|CharlesSchwab
Alliance Data Systems|E3Alliance
Trinity Industries|TrinityJobs
JetBlue Airways|JetBlue
Discovery Communications|DiscoveryComm
FMC Technologies|FMC_Tech
NCR|NCRonline
Sanmina|SanminaCorp
Dr Pepper Snapple Group|DrPepperSnapple
iHeartMedia|iHeartMedia
Rockwell Automation|ROKAutomation
Tractor Supply|TractorSupply
J.B. Hunt Transport Services|jbhunt360
Commercial Metals|GAMetals
Owens-Illinois|DSteen22
American Financial Group|BRIANCULHANE
Baxalta|Baxalta
NetApp|NetApp
Oshkosh|onwnews
Ameren|AmerenMissouri
Barnes & Noble|BNBuzz
Dana Holding|DanaHoldingCorp
Constellation Brands|CBrandsCareers
LifePoint Health|LifePointHealth
PulteGroup|demuthjason
Harley-Davidson|harleydavidson
Newell Brands|newell_brands
WEC Energy Group|WECEnergyGroup
Avery Dennison|AveryDennison
Jones Lang LaSalle|kingsturge
Marathon Oil|MarathonOil
TravelCenters of America|TATravelCenters
HRG Group|HRGNigeria
United Rentals|United_Rentals
Old Republic International|CiaranClark_21
Packaging Corp. of America|packagingcorp
Starwood Hotels & Resorts|Christy1444
Hanesbrands|ClimbWithUs
Realogy Holdings|Realogy
Motorola Solutions|MotoSolutions
Mattel|Mattel
J.M. Smucker|HgryJkPotatoes
Regions Financial|RegionsFI
Clorox|Clorox
Ingredion|Ingredion
Genesis Healthcare|GenesisHCS
Celanese|celanese
Peabody Energy|peabodyenergy
Alaska Air Group|ksavitt
Seaboard|Eseaboard
Frontier Communications|FrontierCorp
Amphenol|AmphenolLtd
Lansing Trade Group|LansingTradeGrp
SanDisk|SanDisk
Wyndham Worldwide|Wyndham
St. Jude Medical|StJudeMedicalIR
Kelly Services|KellyServices
Western Union|WesternUnion
Arthur J. Gallagher|AJGCORPORATE
Visteon|Visteon
Ashland|AshlandPolice
Insight Enterprises|InsightEnt
Energy Future Holdings|EFH_News
Markel|markelgoierri
Essendant|Essendant
CH2M Hill|CH2MHILLAlaska
Western & Southern Financial Group|WSFGMasters
S&P Global|SPGlobal
NiSource|NiSourceInc
Raymond James Financial|RaymondJames
Owens Corning|OwensCorning
Airgas|airgas
ABM Industries|abmIndustries
Citizens Financial Group|CFGCommercial
Simon Property Group|SimonPropertyGp
Lam Research|LamResearch
Rockwell Collins|RockwellCollins
Domtar|DomtarEveryday
Spectra Energy|SpectraEnergy
Fiserv|Fiserv
Big Lots|BigLots
Navient|Navient
Telephone & Data Systems|FutureVAD
NVR|TamarrowNvrDies
Cincinnati Financial|jacincinnati
Burlington Stores|BurlingtonWWP
